1;2;1;2;1;1;1;1;2;1
1;2;1;X;X;X;1;1;1;2
2;X;X;X;2;1;2;1;2;2
1;N;1;1;1;1;1;CC;CN;1
1;1;1;2;2;2;2;2;2;1
1;1;1;C;1;1;2;1;1;1
1;1;1;1;1;X;1;C;1;1
1;N;1;1;P;1;1;1;1;1
1;2;1;1;1;1;2;1;1;1
N;1;1;1;1;1;1;1;N;1