1;2;1;2;1;1;1;1;2;1
1;2;1;X;X;X;1;1;1;1
2;X;X;1;CC;1;2;1;1;2
1;1;1;1;CN;1;1;1;1;1
1;1;1;2;2;2;2;2;C;1
1;1;1;N;1;1;2;1;1;1
1;N;1;1;1;1;N;2;1;1
1;1;1;1;P;1;1;1;1;1
1;2;C;1;N;1;C;1;1;1
1;1;1;1;1;1;1;1;N;1