2;2;1;N;1;2;2
2;CC;1;1;1;CN;2
2;2;2;2;2;2;2
1;1;1;N;1;1;C
X;X;X;1;N;1;1
P;1;1;1;1;1;1
1;1;1;N;1;N;1